NO   textures/NO_texture.xpm
SO textures/SO_texture.xpm
EA textures/EA_texture.xpm
WE textures/WE_texture.xpm

C 40, 24, 120
F 1, 50, 32

11111
1E001
10001
11111

11111
10001
10001
11111