NO   maps/NO_texture.xpm
SO maps/SO_texture.xpm
EA maps/EA_texture.xpm
WE maps/WE_texture.xpm

C 40, 24, 120
F 1, 50, 32

11111
10N01
10001
11111
