NO   maps/NO_texture.xpm
SO maps/SO_texture.xpm
EA maps/EA_texture.xpm
WE maps/WE_texture.xpm

C 40, 24, 120
F 1, 50, 32

1111111111111111111111111
1000000001100000000000011
11111111100000111000000011111111111111111111111111111111111111111111
10010000000000000000000000000000000000000000000000001000000000000001
11111111101100000111000011111111100000000001000000000000000000000001
1000000000110000011101111111111110000W000000001000000010000000000001
11110111111111011100000010001111111111111111111111111111111111111111
1111011111111101 101010010001
11000000110101011100000010001
10000000000000001100000010001
10000000000000000101010011101
11000001110101010101011000111
111101111110101100011010001
111111111111111111111111111