NO   maps/NO_texture.xpm
SO maps/SO_texture.xpm
EA maps/EA_texture.xpm
WE maps/WE_texture.xpm

F 220,100,0
C 225,30,0

111111111111111111
100001   100000001
100001   100000001
111111111111111111
                    
        11111111
        1111111111111111111111111111111111111111111111111111111111111111111111
        100000000011000000000000000000000W000000000000000000000000000000000001
        1000000000000000000000000000000000000000001111000000000000000000000001
        1111111110001111111111111111111111111111111111111111111111111111111111
                10001
                10001
        1111111110001111111111111
111111110000000000000111100111111111111111111111111111111111111111111111111111
10000000000000011100000010001
11111111111111111111111111111