NO   maps/test.xpm
SO maps/SO_texture.xpm
EA maps/EA_texture.xpm
WE maps/WE_texture.xpm

C 40, 24, 120
F 1, 50, 32

1111111111111111111111111     1
1000000000000000000000001     1
1000000000000000000011111     1
1111100000000000000000001
100000000000W000000000001
1000000000000000000000001
1000000000000000000000001
1111111111111111111111111