NO   maps/NO_texture.xpm
SO maps/SO_texture.xpm
EA maps/EA_texture.xpm
WE maps/WE_texture.xpm

F 220,100,0
C 225,30,0

1111111111111111111111111
1000000000000000000000001
1000000001110000000000001
1000000001 1000000N000001
1000000001110000000000001
1000000000000000000111001
10000000000000000001 1001
11111111111111111111 1111