NO   ./path_to_the_north_texture
SO ./path_to_the_south_texture
EA ./path_to_the_east_texture
WE ./path_to_the_west_texture

F 220,100,0
C 225,30,0

111111111111111111
100001   100000001
100001   100000S01
111111111111111111
             1       
        11111111
        1111111111111111111111111111111111111111111111111111111111111111111111
        100000000011000000000000000000S000000000000000000000000000000000000001
        1000000000000000000000000000000000000000001111000000000000000000000001                        
        1111111110001111111111111111111111111111111111111110111111111111111111
                10001
                10001
        1111111110001111111111111
111111110000000000000111100111111111111111111111111111111111111111111111111111
10000000000000011100000010001
11111111111111111111111111111