NO img/north.xpm
SO img/south.xpm
WE img/west.xpm
EA img/east.xpm

F 220,100,0
C 225,30,0

1111111111111111111111111
1000000001100000000000011
11111111100000111000000011111111111111111111111111111111111111111111
10010000000000000000000000000000000000000000000000000000000000000001
11111111101100000111000011111111100000000000000000000000000000000001
10000000001100000111011111111111100000000000000000000000000000000001
11110111111111011100000010001111111111111111111111111111111111111111
1111011111111101 101010010001
11000000110101011100000010001
10000000000000001100000010001
10000000000000000101010011101
110000011101010101010110N0111
111101111110101100011010001
111111111111111111111111111