NO img/north.xpm
SO img/south.xpm
WE img/west.xpm
EA img/east.xpm

F 220,100,0
C 225,30,0

    1111111111111111111111111
    1000000000000000000000001
    1000000000000000000011111
1111100000000000000000001
100000000000W0000000000011111
1000000000000011100000001
100000000000000 100000001
111111111111111 111111111