NO img/north.xpm
SO img/south.xpm
WE img/west.xpm
EA img/east.xpm

F 220,100,0
C 225,,0

11111
10001
10N01
10001
11111