NO maps/NO_texture.xpm
SO maps/SO_texture.xpm
WE maps/WE_texture.xpm
EA maps/EA_texture.xpm

F 220,100,0
C 225,30,0

1111111111111111111111111
1000000000000000000000001
1000000011000000000000001
1000000011000000000000001
100000000000W000000000001
1000000000000000000000001
1000000000000000000000001
1111111111111111111111111
