NO maps/NO_texture.xpm
SO maps/SO_texture.xpm
WE maps/WE_texture.xpm
EA maps/EA_texture.xpm
F 220,100,0
C 225,30,0

        1111111111111111111111111
        1000000000110000000000001111111111
        1011000001110000000000001
        1001000000000000000000001
111111111011000001110000000000001
100000000011000001110111111111111
11110111111111011100000010001
11110111111111011101010010001
11000000110101011100001110001111111111111
10000000000000001100001100001000000000001
10000000000000001101010010001000000000001
11000001110101011111011110N01111111111111
11110111 1110101 1001111010001
11110111 1111111 1111111110111
11110001                10011
11111111                11111        